NO ./path_to_the_north_texture.xpm
SO ./path_to_the_south_texture.xpm
WE ./path_to_the_west_texture.xpm
EA ./path_to_the_east_texture.xpm
F 220,200,0
C 225,30,0
                                
111111111111111111111111      
1000000000110000000000001    
1011000001110000000000001     
100100000000000000000000111111111 
111111111011000001110000000000001 
100000000011000001110111110111111 
11110111111111011100000010001  
11110111111111011101010010001  
1100000011  11011100000010001  
10000000001100001100000010001  
10000W000000000001101010000001  
110000011101010111110111100111 
11110111 1110101 101111010001 
11111111 1111111 111111111111     