NO ./texture/1c61b0435af5cc9d01a1a3364ae31abc.xpm
SO ./texture/east.xpm
EA ./texture/ross-elder-uXQVNkam3hE-unsplash.xpm
WE ./texture/sprite.xpm

F 220,100,0
C 225,30,0

111111111111111111111111111111111
100000000000000000000000000000001
100110010101001000100010010001001
100000000000000000000000000000001
100110010100100100100010010001001
100000000000000000000000000000001
100110010100000000000010010001001
100000000000100000000000000000001
100110010000000000000000010001001
1000000000000000N0000000000000001
100110010100000000000010010001001
100000000000000000000000000000001
100110010100100001001010010001001
111111111111111111111111111111111