SO ./texture/east_texture.xpm
NO ./texture/north_texture.xpm
EA ./texture/east_texture.xpm
WE ./texture/west_texture.xpm

F 0,255,0
C 102,178,255

111111111111111111111111111111111
100000000000000000000000000000001
100110010101001000100010010001001
100000000000000000000000000000001
100110010100100100100010010001001
100000000000000000000000000000001
1001100101000000N0000010010001001
100000000000100000000000000000001
100110010000000000000100010001001
100000000000000000001000000000001
100110010100000000000010010001001
100000000000000000000000000000001
100110010100100001001010010001001
111111111111111111111111111111111







